{
    "1":500,
    "2":1000,
    "3":1500,
    "4":2000,
    "5":2500,
    "6":4000,
    "7":6000,
    "8":8000,
    "9":10000,
    "10":15000
}

